30000000000000000000000000000003
30000000000000000000000000000003
30000000000000000000000000000003
30000000000000000000000000000003
30000000000000000000000000000003
30000000000000000000000000000003
30000000000000000000000000000003
30000000000000000000000000000003
30000000000000000000000000000003
30000000000000000000000000000003
30000000000000000000000000000003
30000000000000000000000000000003
30000000000000000000000000000003
30000000000000000000000000000003
30000000000000000000000000000003
30000000000000000000000000000003
30000000000000000000000000000003
30000000000000000000000000000003
30000000000000000000000000000003
30000000000000000000000000000003
30000000000000000000000000000003
30000000000000000000000000000003
38888888888888888888888888888883
32222222222222222222222222222223
30000000000000000000000000000003
30000000000000000000000000000003
30000000000005050500000000000003
30000000000022222220000000000003
30000000000000000000000000000003
30000000000000000000000000000003
30000000000005050500000000000003
36000000000022222220000000000003
30000000000000000000000000000003
30000000000000000000000000000003
30000000000000000000000000000003
30000000050000222000050000000003
30000000000000000000000000000003
30000000000000000000000000000003
30000000000005050500000000000003
30000000000022222220000000000003
30000000000000000000000000000003
30000000000000000000000000000003
30000000000000000000000000000003
32222222222222222222222222222223
30000000000000000000000000000003
30000000000000000000000000000003
30050505050505050505050505050503
32222222222222222222222222222223
30000000000000000000000000000003
30000000000000000000000000000003
30505050505050505050505050505003
32222222222222222222222222222223
30000000000000000000000000000003
30000000000000000000000000000003
30505050000000000000000000000003
32222222000000000000000000000003
30000000000000000000000000000003
30000000000000000000000000000003
30505050000000000000000000000003
32222222000000000000000000000003
30000000000000000000000000000003
30000000000000010000000000000003
30000000000000000000000000000003
32222222222222222222222222222223
30000000000000000000000000000003
30000000000000000000000000000003
30000000000000000000000000000003
32222222222222222222222222222223
30000000000000000000000000000003
30000000000000000000000000000003
30000000000000000000000000000003
32222222222222222222222222222223