30000000000000000000000000000003
30000000000000000000000000000003
30000000000000000000000000000003
30000000000000000000000000000003
30000000000000000000000000000003
30000000000000000000000000000003
30000000000000000000000000000003
30000000000000000000000000000003
30000000000000000000000000000003
30000000000000000000000000000003
30000000000000000000000000000003
30000000000000000000000000000003
30000000000000000000000000000003
30000000000000000000000000000003
30000000000000000000000000000003
30000000000000000000000000000003
30000000000000000000000000000003
30000000000000000000000000000003
30000000000000000000000000000003
30000000000000000000000000000003
30000000000000000000000000000003
30000000000000000000000000000003
39999999999999999999999999999993
32222222222222222222222222222223
30000000000000000000000000000003
30000000000000000000000000000003
30000000707070707070000000000003
30000004444440000000000000000003
30000000000000000000000000000003
30000000000000000000000000000003
30707070000000000000000007070703
32222222000000000000000022222223
30000000000000000000000000000003
30000000000000000000000000000003
30707070000000000000000007070703
32222222000000000000000022222223
30000000000000000000000000000003
30000000000000000000000000000003
30000000000000000000000000000003
32222222222222222222222222222223
30000000000000000000000000000003
30000000000000000000000000000003
30000000000000000000000000000003
30000000000000000000000000000003
30000000000000000000000000000003
30000000000000000000000000000003
30000000000000000000005555550003
30000000000000000000000000000003
30000000707070707000000000000003
30000004444440000000000000000003
30000000000000000000000000000003
30000000000000000000000000000003
30070000000000000000000000000003
30222000000000000000000000000003
30000000000000000000000000000003
30000000000000000000000000000003
30070000000000000000000000000003
30222000000000000000000000000003
30000000000000000000000000000003
30000000000000000000000000000003
30707070000000707070000000000003
32222222000002222222000000000003
30000000000000000000000000000003
30000000000000000000000000000003
30000000000000000000000007070703
30000000000000000000000022222223
30000000000000000000000000000003
30000000000000000000000000000003
30707070000000707070000000000003
32222222000002222222000000000003
30000000000000000000000000000003
30000000000000000000000000000003
30000000000000000000000000000003
32222222222222222222222222222223
30000000000000000000000000000003
30000000000000000000000000000003
30000000707070707000000000000003
30000004444440000000000000000003
30000000000000000000000000000003
30000000000000000000000000000003
30000000000000000000000007070703
30000000000000000000000022222223
30000000000000000000000000000003
30000000000000000000000000000003
30000000000000000000000007070703
30000000000000000000000022222223
30000000000000000000000000000003
30000000000000000000000000000003
30000000000007070700000000000003
30000000000022222220000000000003
30000000000000000000000000000003
30000000000000000000000000000003
30707070000000000000000000000003
32222222000000000000000000000003
30000000000000000000000000000003
30000000000000000000000000000003
30000000000007070700000000000003
30000000000022222220000000000003
30000000000000000000000000000003
30000000000000000000000000000003
30000000000000000000000007070703
30000000000000000000000022222223
30000000000000000000000000000003
30000000000000000000000000000003
30000000000000000000070707000003
30000000000000000000222222200003
30000000000000000000000000000003
30000000000000000000000000000003
30000000000007070700000000000003
38000000000022222220000000000003
30000000000000000000000000000003
30000000000000000000000000000003
30000000070000000000070000000003
30000000000000222000000000000003
30000000000000000000000000000003
30000000000000000000000000000003
30000000000007070700000000000003
30000000000022222220000000000003
30000000000000000000000000000003
30000000000000000000000000000003
30000000000000000000000000000003
32222222222222222222222222222223
30000000000000000000000000000003
30000000000000000000000000000003
30070707070707070707070707070703
32222222222222222222222222222223
30000000000000000000000000000003
30000000000000000000000000000003
30707070707070707070707070707003
32222222222222222222222222222223
30000000000000000000000000000003
30000000000000000000000000000003
30707070000000000000000000000003
32222222000000000000000000000003
30000000000000000000000000000003
30000000000000000000000000000003
30707070000000000000000000000003
32222222000000000000000000000003
30000000000000000000000000000003
30000000000000010000000000000003
30000000000000000000000000000003
32222222222222222222222222222223
30000000000000000000000000000003
30000000000000000000000000000003
30000000000000000000000000000003
32222222222222222222222222222223
30000000000000000000000000000003
30000000000000000000000000000003
30000000000000000000000000000003
32222222222222222222222222222223