30000000000000000000000000000003
30000000000000000000000000000003
30000000000000000000000000000003
30000000000000000000000000000003
30000000000000000000000000000003
30000000000000000000000000000003
30000000000000000000000000000003
30000000000000000000000000000003
30000000000000000000000000000003
30000000000000000000000000000003
30000000000000000000000000000003
30000000000000000000000000000003
30000000000000000000000000000003
30000000000000000000000000000003
30000000000000000000000000000003
30000000000000000000000000000003
30000000000000000000000000000003
30000000000000000000000000000003
30000000000000000000000000000003
30000000000000000000000000000003
36666666666666666666666666666663
32222222222222222222222222222223
30000000000000000000000000000003
30000000000000000000000000000003
30000000000000000000000000555553
30000000000000000000000000222223
30000000000000000000000000000003
30000000000000000000000000000003
30000000000000000000000000555553
30000000000000000000000000222223
30000000000000000000000000000003
30000000000000000000000000000003
30000000000000000000000000555553
32222222222200000000000000222223
30000000000000000000000000000003
30000000000000000000000000000003
35555555500000000000000000000003
32222222200000000000000000000003
30000000000000000000000000000003
30000000000000000000000000000003
35555555500000000000000000000003
32222222200000000000000000000003
30000000000000000000000000000003
30000000000000010000000000000003
30000000000000000000000000000003
32222222222222222222222222222223
30000000000000000000000000000003
30000000000000000000000000000003
30000000000000000000000000000003
32222222222222222222222222222223
30000000000000000000000000000003
30000000000000000000000000000003
30000000000000000000000000000003
32222222222222222222222222222223